NO ./textures/path_to_the_north_texture
WE ./textures/path_to_the_west_texture

C 186, 199, 45
F 225, 30, 0

1111111111111111111111
	100000000000000001
	1000000000000000011111111111
	1000000000000000000000000001
	1000000000000000000000000001
11111111111100000000011111111111
11111111111100000000011111111111
11111111111100000000011111111111
11111111111111100011111111111111
			  11111