SO ./textures/path_to_the_south_texture
EA ./textures/path_to_the_east_texture
EA ./textures/path_to_the_east_texture
NO ./textures/path_to_the_north_texture

C 186, 199, 45
F 225, 30, 0











11111111111111111111111
      100000000000000011111
   111100000000000000001
111000000000000000000111
111110000000000000000111111
    1100000000000000000000111
111110000000000000000000000011
10000000000000000000011111111
100000000000000000111111111
1000000000000000111 1000001
11111000000000001  110000011
1000100000000000   1000000011111111
1000000000000111   1100000000000001
11111111111111      111111111111111