SO ./textures/path_to_the_south_texture
EA ./textures/path_to_the_east_texture
WE ./textures/path_to_the_west_texture
NO ./textures/path_to_the_north_texture

F 225, 30, 0
C 186, 199, 45

		11111111111111111111111
		10000000000000000000001111111
		10000000000000000000000000001
	111110000000000000000000111111111
	1111100000000000400000000001
		100000000000000000000001111111
	1111100000000000000000000000000001
   11000000000000000000000000000000111
	11111111000000000000000000000001
	10000000000000000000000000000111
	111110000001111111111111111111
	1000000000000111111111111111
	1111111100000000000000000001
		   111111111111111111111