SO ./textures/path_to_the_south_texture
EA ./textures/path_to_the_east_texture
WE ./textures/path_to_the_west_texture
NO ./textures/path_to_the_north_texture

F 225, 30, 0
C 186, 199, 45


   11111111111111111111111
   10000000000000000000001111111
   10000000000000000000000000001
111110000000000000000000111111111
1111100000000000000000000001
   100000000000000000000001111111
1111100000000000000000000000000000000000000000000000001
   1000000000000000000000000000000111
11111111000000000000000000000001
10000000000000000000000000000111
111110000001111111111111111111
1000000000000111111111111111
1111111100000000000000000001
       111111111111111111111


11111111111111111111111
      100000000000000011111
   111100000000000000001
111000000000000000000111
111110000000000000000111111
    1100000000000000000000111
111110000000000000000000000011
10000000000000000000011111111
100000000000000000111111111
1000000000000000111 1000001
11111000000000001  110000011
1000100000000000   1000000011111111
1000000000000111   1100000000000001
11111111111111      101111111111111