SO ./textures/red_drapes2.xpm
EA ./textures/red_drapes2.xpm
WE ./textures/red_drapes2.xpm
NO ./textures/red_drapes2.xpm

F 161, 12, 12
C 57, 1, 0

11111111111111111111111
      1000S0000000000011111
   111100000000000000001
111000000010000000000111
1111100000010000000000111111
    1100000011000000000000111
1111100000111111000001000000011
10000000001000000000011011111
10000000111000000011111C111
1000000000100000111 1000001
11111000010000001  110010011
10001C1110100001   1000110011111111
1000C00000000111   11001000000C001
1111111111C111      1C1111111111111
      100000001111111011111
   111100000000000000001
111000000000000001000111
111110000000000111111111111
    1100011000000100000000111
111110000001111000100000000011
1010C000000100000000011C11111
101011111100000000111110111
1000100001000000111 1000001
11111001100000001  110000011
1000100100000001   1000000011111111
1000000000000111   11000000C000001
11111111111111      111111111111111