SO ./textures/red_drapes2.xpm
EA ./textures/red_drapes2.xpm
WE ./textures/red_drapes2.xpm
NO ./textures/red_drapes2.xpm



F 161, 12, 12
C 57, 1, 0

        111111111111111111111111
        1000000000110000000000001
        10110000011100000W000000111111
        10010000000000010000001
111111111011000001110000000000001
10000000001100000111C111111111111
11110111111111C11100000010001
11110111111111011101010010001
11000000110101011100000010001
10000000000000001100000010001
10000000000000001101010000001
110000011101010111100111000111
11110111 1110101 101000010001
11111111 1111111 111111111111
