SO ./textures/test_Cub3D.xpm
EA ./textures/path_to_the_east_texture
WE ./textures/path_to_the_west_texture
NO ./textures/path_to_the_north_texture

F 204, 0, 1020000000000000000000
C 102, 51, 0

        1111111111111111111111111
        1000000000110000000000001
        1011000001110000000000001
        1001000000000000N00000001
111111111011000001110000000000001
10000000001100000111C111111111111
11110111111111011100000010001
11110111111111011101010010001
11000000110101011100000010001
10000000000000001100000010001
10000000000000001101010000001
110000011101010111110111000111
11110111 1110101 101111010001
11111111 1111111 111111111111

les contours de la map doivent etre fermes
1 pour les murs
0 pour les espaces vides
un seul personnage donc une seule lettre N,S,E ou W